ClandestineDrifting
An Interactive Fiction by booleanPro
Release 1 / Serial number 210919 / Inform 7 build 6M62 (I6/v6.33 lib 6/12N) SD

bedroom
You live on the 2nd floor of an apartment. You just woke up from your evening nap. It is 9 o clock. You drift off to the shiny piece of metal that hangs on your key hanger next to the door of the living room. It's Drift Night with the boys! You jump out of bed quickly. You are inside, in the bedroom. To your north is a small division that separates your apartment from the bathroom and the living room.

You can see Bedroom door here.

>look
apartment
You live on the 2nd floor of an apartment. You just woke up from your evening nap. It is 9 o clock. You drift off to the shiny piece of metal that hangs on your key hanger next to the door of the living room. It's Drift Night with the boys! You jump out of bed quickly.

* * *

ClandestineDrifting
An Interactive Fiction by booleanPro
Release 1 / Serial number 210919 / Inform 7 build 6M62 (I6/v6.33 lib 6/12N) SD

bedroom
You live on the 2nd floor of an apartment. You just woke up from your evening nap. It is 9 o clock. You drift off to the shiny piece of metal that hangs on your key hanger next to the door of the living room. It's Drift Night with the boys! You jump out of bed quickly. You are inside, in the bedroom. To your north is a small division that separates your apartment from the bathroom and the living room.

You can see Bedroom door here.

>examine apartment door
A brown door with matching bronze-decaying handles and hinges.

>open door
You open Apartment door.

>see
That's not a verb I recognise.

>look
bedroom
You live on the 2nd floor of an apartment. You just woke up from your evening nap. It is 9 o clock. You drift off to the shiny piece of metal that hangs on your key hanger next to the door of the living room. It's Drift Night with the boys! You jump out of bed quickly. You are inside, in the bedroom. To your north is a small division that separates your apartment from the bathroom and the living room.

You can see Apartment door here.

>go into bathroom
You can't see any such thing.

>go north
bathroom
This room is what you like to call your place of zen and piece...
a.k.a your private place...

You can see Apartment door here.

* * *

ClandestineDrifting
An Interactive Fiction by booleanPro
Release 1 / Serial number 210919 / Inform 7 build 6M62 (I6/v6.33 lib 6/12N) SD

bedroom
You live on the 2nd floor of an apartment. You just woke up from your evening nap. It is 9 o clock. You drift off to the shiny piece of metal that hangs on your key hanger next to the door of the living room. It's Drift Night with the boys! You jump out of bed quickly. You are inside, in the bedroom. To your north is a small division that separates your apartment from the bathroom and the living room.

You can see Bedroom door here.

>go south
You can't go that way.

>go west
You can't go that way.

>go east
You can't go that way.

>go north
(first opening Bedroom door)

division
Middle ground room between the bathroom and the bedroom

You can see Bedroom door, Living room door and Bathroom door here.

>go south
bedroom
You live on the 2nd floor of an apartment. You just woke up from your evening nap. It is 9 o clock. You drift off to the shiny piece of metal that hangs on your key hanger next to the door of the living room. It's Drift Night with the boys! You jump out of bed quickly. You are inside, in the bedroom. To your north is a small division that separates your apartment from the bathroom and the living room.

You can see Bedroom door here.

>open door
That's already open.

>go north
division
Middle ground room between the bathroom and the bedroom

You can see Bedroom door, Living room door and Bathroom door here.

>open door
Which do you mean, Bedroom door, Living room door or Bathroom door?

>open bathroom door
You open Bathroom door.

>go bathroom
bathroom
This room is what you like to call your place of zen and piece...
a.k.a your private place...

You can see Bathroom door here.

>go north
You can't go that way.

>go south
division
Middle ground room between the bathroom and the bedroom

You can see Bathroom door, Bedroom door and Living room door here.

>open living room door
You open Living room door.

>go north
bathroom
This room is what you like to call your place of zen and piece...
a.k.a your private place...

You can see Bathroom door here.

>go south
division
Middle ground room between the bathroom and the bedroom

You can see Bathroom door, Bedroom door and Living room door here.

>go to living room
You can't see any such thing.

>open living room door
That's already open.

>go living room
living room
You are now in the living room. This room allows you to breathe in from the window you keep open all day. On the far, where the window is, you can see the shiny green logo of the Razer snakes, where your fancy, shmancy powerful computer sits ready to be used. However, that's now what you have in mind right now...

You can see Living room door here.

>go west
You can't go that way.

>go south
kitchen
You are in the kitchen, where you still faintly smell the garlic and the oil from your earlier meal. What was it?...

Ah yes, teriyaki chicken, chow mein, and fried rice from your favorite Thai place out in Echo Park.
Anyways, where were we?...

>go west
You can't go that way.

* * *

>go east
You can't go that way.

>go south
You can't go that way.

>north
living room
You are now in the living room. This room allows you to breathe in from the window you keep open all day. On the far, where the window is, you can see the shiny green logo of the Razer snakes, where your fancy, shmancy powerful computer sits ready to be used. However, that's now what you have in mind right now...

You can see Living room door here.

>south
kitchen
You are in the kitchen, where you still faintly smell the garlic and the oil from your earlier meal. What was it?...

Ah yes, teriyaki chicken, chow mein, and fried rice from your favorite Thai place out in Echo Park.
Anyways, where were we?...

>north
living room
You are now in the living room. This room allows you to breathe in from the window you keep open all day. On the far, where the window is, you can see the shiny green logo of the Razer snakes, where your fancy, shmancy powerful computer sits ready to be used. However, that's now what you have in mind right now...

You can see Living room door here.

* * *

ClandestineDrifting
An Interactive Fiction by booleanPro
Release 1 / Serial number 210919 / Inform 7 build 6M62 (I6/v6.33 lib 6/12N) SD

bedroom
You live on the 2nd floor of an apartment. You just woke up from your evening nap. It is 9 o clock. You drift off to the shiny piece of metal that hangs on your key hanger next to the door of the living room. It's Drift Night with the boys! You jump out of bed quickly. You are inside, in the bedroom. To your north is a small division that separates your apartment from the bathroom and the living room.

You can see Bedroom door here.

>door
That's not a verb I recognise.

>dance
That's not a verb I recognise.

>drift
That's not a verb I recognise.

* * *

>door
That's not a verb I recognise.

>go door
(first opening Bedroom door)

division
Middle ground room between the bathroom and the bedroom

You can see Bedroom door, Living-room door and Bathroom door here.

>west
(first opening Living-room door)

living-room room
You are now in the living room. This room allows you to breathe in the carbon exhausts from the cars outside because you always keep the living room window open. On the far wall, where the window is, you can see the shiny green logo of the Razer snakes, where your fancy, shmancy powerful computer sits ready to be used. However, that's now what you have in mind right now...

On the key hanger are a house key, a GTI keys Key and a safe key.

You can also see Living-room door and Apartment door here.

>north
(first opening Apartment door)

main apartment hallway
You are outside of your apartment. The smell of cigarettes fills your nose as you step into the main apartment hallway. Your next door neighbor must have had another bad day at work again. It looks darker than it does in your apartment. Get away from the stench by taking the stairs

You can see Apartment door here.

>down
sidewalk
As you step onto the sidewalk, you can't help but notice the stock cars lined up along the curb. You take in fresh air as you look left and right at the dark apartments, which are, one by one, turning off their lights for the night. It's time for drifting.

>south
driveway
You plant yourself firmly on the jagged, old, black asphalt of the building's driveway. Just steps from you is your beloved beauty. It hides in the dark shadows of the night. Although it is a spectrum oak green, it looks almost black because of tonight's new moon. It's going to be a perfect night to show off your new Billetworkz shifter as it glows red from the overhead interior lights of your car.

>east
garage
You love and hate the fact that you can't have your own garage door. Love it because, well, everyone who passes by can see it. Hate it, because you sometimes, you want the car to have its own private space, especially when it's leaking oil late after a midnight run... Oh, yeah. It has no lights. Now that's annoying.

>see
That's not a verb I recognise.

>look
garage
You love and hate the fact that you can't have your own garage door. Love it because, well, everyone who passes by can see it. Hate it, because you sometimes, you want the car to have its own private space, especially when it's leaking oil late after a midnight run... Oh, yeah. It has no lights. Now that's annoying.

>examine garage
You can't see any such thing.

* * *

ClandestineDrifting
An Interactive Fiction by booleanPro
Release 1 / Serial number 210919 / Inform 7 build 6M62 (I6/v6.33 lib 6/12N) SD

bedroom
You live on the 2nd floor of an apartment. You just woke up from your evening nap. It is 9 o clock. You drift off to the shiny piece of metal that hangs on your key hanger next to the door of the living room. It's Drift Night with the boys! You jump out of bed quickly. You are inside, in the bedroom. To your north is a small division that separates your apartment from the bathroom and the living room.

You can see Bedroom door here.

>sleep
You aren't feeling especially drowsy.

>wake
The dreadful truth is, this is not a dream.

>dream
That's not a verb I recognise.

>dress
That's not a verb I recognise.

>go north
(first opening Bedroom door)

division
Middle ground room between the bathroom and the bedroom

You can see Bedroom door, Living-room door and Bathroom door here.

>go west
(first opening Living-room door)

living-room room
You are now in the living room. This room allows you to breathe in the carbon exhausts from the cars outside because you always keep the living room window open. On the far wall, where the window is, you can see the shiny green logo of the Razer snakes, where your fancy, shmancy powerful computer sits ready to be used. However, that's now what you have in mind right now...

On the key hanger are a house key, a GTI keys Key and a safe key.

You can also see Living-room door and Apartment door here.

>go south
kitchen
You are in the kitchen, where you still faintly smell the garlic and the oil from your earlier meal. What was it?...

Ah yes, teriyaki chicken, chow mein, and fried rice from your favorite Thai place out in Echo Park.
Anyways, where were we?...

>go north
living-room room
You are now in the living room. This room allows you to breathe in the carbon exhausts from the cars outside because you always keep the living room window open. On the far wall, where the window is, you can see the shiny green logo of the Razer snakes, where your fancy, shmancy powerful computer sits ready to be used. However, that's now what you have in mind right now...

On the key hanger are a house key, a GTI keys Key and a safe key.

You can also see Living-room door and Apartment door here.

>examine key hanger
Another brown object, a hanger where you hang and keep all your keys. There's the house key, GTI keys, work keys, and a odd-looking silver key...

On the key hanger are a house key, a GTI keys Key and a safe key.

>north
(first opening Apartment door)

main apartment hallway
You are outside of your apartment. The smell of cigarettes fills your nose as you step into the main apartment hallway. Your next door neighbor must have had another bad day at work again. It looks darker than it does in your apartment. Get away from the stench by taking the stairs

You can see Apartment door here.

* * *

>down
sidewalk
As you step onto the sidewalk, you can't help but notice the stock cars lined up along the curb. You take in fresh air as you look left and right at the dark apartments, which are, one by one, turning off their lights for the night. It's time for drifting.

>north
You can't go that way.

>east
You can't go that way.

>west
You can't go that way.

>south
driveway
You plant yourself firmly on the jagged, old, black asphalt of the building's driveway. Just steps from you is your beloved beauty. It hides in the dark shadows of the night. Although it is a spectrum oak green, it looks almost black because of tonight's new moon. It's going to be a perfect night to show off your new Billetworkz shifter as it glows red from the overhead interior lights of your car.

>see
That's not a verb I recognise.

>look
driveway
You plant yourself firmly on the jagged, old, black asphalt of the building's driveway. Just steps from you is your beloved beauty. It hides in the dark shadows of the night. Although it is a spectrum oak green, it looks almost black because of tonight's new moon. It's going to be a perfect night to show off your new Billetworkz shifter as it glows red from the overhead interior lights of your car.

>examine driveway
You can't see any such thing.

>north
sidewalk
As you step onto the sidewalk, you can't help but notice the stock cars lined up along the curb. You take in fresh air as you look left and right at the dark apartments, which are, one by one, turning off their lights for the night. It's time for drifting.

>south
driveway
You plant yourself firmly on the jagged, old, black asphalt of the building's driveway. Just steps from you is your beloved beauty. It hides in the dark shadows of the night. Although it is a spectrum oak green, it looks almost black because of tonight's new moon. It's going to be a perfect night to show off your new Billetworkz shifter as it glows red from the overhead interior lights of your car.

>west
You can't go that way.

>east
You can't go that way.

>south
You can't go that way.

* * *

ClandestineDrifting
An Interactive Fiction by booleanPro
Release 1 / Serial number 210919 / Inform 7 build 6M62 (I6/v6.33 lib 6/12N) SD

bedroom
You live on the 2nd floor of an apartment. You just woke up from your evening nap. It is 9 o clock. You drift off to the shiny piece of metal that hangs on your key hanger next to the door of the living room. It's Drift Night with the boys! You jump out of bed quickly. You are inside, in the bedroom. To your north is a small division that separates your apartment from the bathroom and the living room.

You can see Bedroom door here.

>north
(first opening Bedroom door)

division
Middle ground room between the bathroom and the bedroom

You can see Bedroom door, Living-room door and Bathroom door here.

>west
(first opening Living-room door)

living-room room
You are now in the living room. This room allows you to breathe in the carbon exhausts from the cars outside because you always keep the living room window open. On the far wall, where the window is, you can see the shiny green logo of the Razer snakes, where your fancy, shmancy powerful computer sits ready to be used. However, that's now what you have in mind right now...

You can see Living-room door, Apartment door and a key hanger (on which are a house key, a GTI-keys Key and a safe key) here.

>take key hanger
You get the house key and put it in your pocket.

>examine key hanger
Another brown object, a hanger where you hang and keep all your keys. There's the house key, GTI keys, work keys, and a odd-looking silver key...

On the key hanger are a house key, a GTI-keys Key and a safe key.

>take gti-keys
Taken.

>take safe key
Taken.

>north
(first opening Apartment door)

main apartment hallway
You are outside of your apartment. The smell of cigarettes fills your nose as you step into the main apartment hallway. Your next door neighbor must have had another bad day at work again. It looks darker than it does in your apartment. Get away from the stench by taking the stairs

You can see Apartment door here.

* * *

>south
driveway
You plant yourself firmly on the jagged, old, black asphalt of the building's driveway. Just steps from you is your beloved beauty. It hides in the dark shadows of the night. Although it is a spectrum oak green, it looks almost black because of tonight's new moon. It's going to be a perfect night to show off your new Billetworkz shifter as it glows red from the overhead interior lights of your car.

>east
garage
You love and hate the fact that you can't have your own garage door. Love it because, well, everyone who passes by can see it. Hate it, because you sometimes, you want the car to have its own private space, especially when it's leaking oil late after a midnight run... Oh, yeah. It has no lights. Now that's annoying.

There it is. Parked and basking in darkness is your beautiful 2018 Volkswagen GTI Rabbit. You use your phone's flashlight to check the car to make sure that there are no new marks on it's eerily dark body. The spectrum oak green color comes into view, as it shines under your phone's effervescent blue light. It looks just as you had it yesterday, and the day before that, and the day before that one, as if just came out of the factory. It's been 3 years and it still looks brand new.

>get in car
You can't see any such thing.

>see gti
That's not a verb I recognise.

>look gti
The GTI is empty.

>get in gti
You get into the GTI.

>get in gti
But you're already in the GTI.

>get out of gti
I only understood you as far as wanting to get outside.

>get out gti
I only understood you as far as wanting to get outside.

>garage
That's not a verb I recognise.

>north
You can't go that way.

>exit gti
I only understood you as far as wanting to exit.

>exit car
I only understood you as far as wanting to exit.

>exit
You get out of the GTI.

garage
You love and hate the fact that you can't have your own garage door. Love it because, well, everyone who passes by can see it. Hate it, because you sometimes, you want the car to have its own private space, especially when it's leaking oil late after a midnight run... Oh, yeah. It has no lights. Now that's annoying.

There it is. Parked and basking in darkness is your beautiful 2018 Volkswagen GTI Rabbit. You use your phone's flashlight to check the car to make sure that there are no new marks on it's eerily dark body. The spectrum oak green color comes into view, as it shines under your phone's effervescent blue light. It looks just as you had it yesterday, and the day before that, and the day before that one, as if just came out of the factory. It's been 3 years and it still looks brand new.

>car-handle
That's not a verb I recognise.

>car handle
That's not a verb I recognise.

>handle
That's not a verb I recognise.

>car
That's not a verb I recognise.

>enter car
You can't see any such thing.

>enter gti
You get into the GTI.